000000001000101100
110100111011110101
111100110111010010
111101011100001100
011110010100011001
101001010000110100
010101010111101100
101110011010011100
000111111101110011
010010100010000010
