111111111011111111
000000000100000000
000111100100111100
001111110101111110
001111110101111110
001111110101111110
000111100100111100
000000000100000000
000000000100000000
111111111011111111

