100000001000010000
010000010010010000
001000100001010000
000101000100010000
000010000010010000
000010011111111111
000010000000101000
000010000001000100
000010000010000010
000010000100000001
