000000000000000000
011111111111111110
011111111111111110
011000000000000110
011011111111110110
011011111111110110
011000000000000110
011111111111111110
011111111111111110
000000000000000000
