000000001100000000
000000011110000000
000000111111000000
000001110011100000
000011110011110000
000111111111111000
001111111111111100
000000111111000000
000000110011000000
000000111111000000
