011011110111111111
111110111111011110
110101111101010111
111111101111010011
101111111111111111
111100111011111111
111111111111110001
111110111111111110
011111010111111110
111011111111111110
