111110110111110111
011111010111111001
110001001111101101
111111110011110010
111001101111011111
111110111101011111
101111011111111111
000011000111110011
101111111101010111
110010111011101011
